		WE       ./textures/64/EW.xpm
	NO    ./textures/64/nord.xpm
			F 		30,      200    ,	    7      0    

SO 				./textures/64/sud.xpm	

 EA 				./textures/64/EW.xpm
C       0,   	  0,    			1     5            0
11111111111111111111111111
10000000000110000000000001
1011000001110000000000001
1001000000000000000000001
111111111011000001110000011111111
100000000011000001110111111111111
1111011111  111011100000010001
1111011111  1111011101010010001
11000000111101011100000010001
100000000000000011S0000010001
10000000000000001101010010001
1100000111010101111101111000111
111101111 1110101 101111010001
111111111 1111111 111111111111
