		WE       ./textures/64/EW.xpm
	NO    ./textures/64/nord.xpm
			F 		30,      200    ,	    7      0    

SO 				./textures/64/sud.xpm	





 EA 				./textures/64/EW.xpm
C       0,   	  0,    			1     5            0
111111111111111111111
100000000000000000001
100000000000000000001
100000000000000000001
100000000111000000001
100000000000000000001
100010000S00000100001
100000000000000100001
100000000000000000001
100011100000000000001
100000000000000000001
100000000000000000001
111111111111111111111
