SO ./img/SO.xpm
F 1,0,123
WE ./img/WE.xpm
EA ./img/EA.xpm
NO ./img/NO.xpm
C 255,0,255

111111111111111111111
100000000000000000001
100000N00000000000001
100000000000000000001
100000000111000000001
100000000000000000001
100010000010000100001
1000000001 100100001
100000000010000000001
100011100000000000001
100000000000000000001
111111111111111111111
111111111111111111111
100000000000000000001
111111111111111111111
