NO ./img.xpm
SO ./img.xpm
WE ./img.xpm
EA ./img.xpm
F 220,100,0
C 225,30,0

 1111111111111111
    10001   11111
11110001   10011
1N01100111111111 
100110000011    
1001100000011    
1001111110011    
1111111111111    