NO ./img.xpm
SO ./img.xpm
WE ./img.xpm
EA ./img.xpm
F 220,100,0
C 225,30,0

11111111111111111111111111
1000000000011000000000001
1011000001110000000000001
1001000000000000000000001
111111111011000001110000011111111
100000000011000001110111111111111
1111011111  111011100000010001
1111011111  1111011101010010001
110000001111010111000000100011
100000000000000011S0000010001
10000000000000001101010010001
1100000111010101111101111000111
111101111 1110101 101111010001
111111111 1111111 111111111111