NO ./img/NO.xpm
SO ./img/SO.xpm
WE ./img/WE.xpm
EA ./img/EA.xpm
F 69,153,15
C 255,255,255

111111111111111111111
100000000000000000001
100000S00000000000001
100000000000000000001
100000000111000000001
100000000000000000001
100010000000000100001
100000000000000100001
100000000000000000001
100011100000000000001
100000000000000000001
100000000000000000001
111111111111111111111
