                  11 11                        
                  10001         1001                           
                101 1S1                             
                  11111                          