                  11 11                        
                  10001         1001                           
                101 1S1                             
                  1111 
                 11
                 111